4 4 4 0 0 0 0 0 0 0 0 0 0 0 0 0
4 4 4 0 0 0 0 1 0 1 0 1 1 1 0 0
4 4 4 0 0 0 1 0 0 0 0 0 0 0 0 0
0 0 0 0 1 0 0 0 0 0 0 0 0 0 1 0
0 0 1 0 0 0 0 0 0 0 0 0 0 0 0 0
1 1 0 0 1 0 0 2 2 0 0 4 4 0 1 0
0 0 0 0 0 0 0 2 2 0 0 4 4 0 0 0
0 0 1 0 0 0 0 2 2 0 0 0 0 0 1 0
0 1 0 0 1 0 0 2 2 0 0 1 0 0 0 0
1 0 0 0 0 0 0 2 2 2 2 2 2 2 2 2
0 0 1 0 1 0 0 2 2 2 2 2 2 2 2 2
1 0 0 0 0 0 0 2 2 0 0 0 0 0 0 0

#0 - dirt
#1 - dirt2
#2 - wood
#3 - darkTile
#4 - water
#5 - grass
#6 - tree